1 1 1 1 1 1 1 1 1 1 1 1 1 1 1
1 2 0 0 0 0 0 1 0 0 0 0 0 0 1
1 0 1 0 0 0 0 1 0 0 0 0 1 0 1
1 0 0 1 1 6 0 1 0 0 0 1 0 0 1
1 0 0 1 1 0 0 1 5 0 1 0 0 0 1
1 0 1 0 0 0 0 0 0 0 0 0 0 0 1
1 0 0 7 0 4 1 1 1 0 0 1 1 1 1
1 1 1 1 0 0 1 1 1 0 0 0 0 0 1
1 0 0 0 0 0 0 0 0 0 7 0 1 0 1
1 1 0 0 1 7 0 1 0 6 1 0 0 0 1
1 0 0 1 0 0 0 1 0 0 1 1 5 5 1
1 0 1 0 0 0 0 1 0 0 0 0 1 0 1
1 8 0 0 0 0 0 1 0 0 0 0 0 3 1
1 1 1 1 1 1 1 1 1 1 1 1 1 1 1