1 1 1 1 1 1 1 1 1 1 1 1 1 1 1
1 0 0 0 0 0 0 8 8 8 8 8 0 0 1
1 0 1 0 0 0 0 8 8 0 0 0 1 0 1
1 0 0 1 6 6 0 8 8 0 0 1 8 8 1
1 0 0 2 1 0 0 8 5 0 1 0 0 0 1
1 0 0 0 0 0 0 8 8 8 8 0 0 0 1
1 0 0 7 1 4 1 1 1 0 8 1 1 1 1
1 1 1 1 8 8 8 8 8 8 8 8 8 8 1
1 0 0 0 8 0 0 0 0 8 7 8 0 8 1
1 1 0 0 1 7 0 0 0 6 1 0 0 0 1
1 0 0 1 0 0 8 3 0 8 8 1 0 5 1
1 8 1 1 8 8 8 0 0 0 1 1 1 1 1
1 0 0 0 8 8 8 5 8 0 0 8 0 5 1
1 1 1 1 1 1 1 1 1 1 1 1 1 1 1