1 1 1 1 1 1 1 1 1 1 1 1 1 1 1
1 0 0 0 0 0 0 0 0 0 0 0 0 0 1
1 0 1 0 0 0 0 0 0 0 0 0 1 0 1
1 0 0 1 6 6 0 0 0 0 0 1 0 0 1
1 0 0 2 1 0 0 0 5 0 1 0 0 0 1
1 0 0 0 0 0 0 0 0 0 0 0 0 0 1
1 0 0 7 1 4 1 1 1 0 0 1 1 1 1
1 1 1 1 8 8 8 8 8 0 0 0 0 0 1
1 0 0 0 0 0 0 0 0 0 7 0 0 0 1
1 1 0 0 1 7 0 0 0 6 1 0 0 0 1
1 0 0 1 0 0 0 3 0 0 0 1 5 5 1
1 0 1 1 8 8 8 0 0 0 1 1 1 1 1
1 0 0 0 8 8 8 5 0 0 0 0 0 0 1
1 1 1 1 1 1 1 1 1 1 1 1 1 1 1