1 1 1 1 1 1 1 1 1 1 1 1 1 1 1
1 2 4 0 0 0 0 1 0 0 8 0 0 8 1
1 0 1 0 0 0 0 1 8 4 8 0 1 8 1
1 0 9 1 1 10 0 1 0 0 0 1 0 8 1
1 0 0 1 1 8 0 1 8 0 1 8 8 6 1
1 0 1 0 0 0 0 0 0 0 8 8 8 8 1
1 0 0 7 0 9 1 1 1 0 0 1 1 1 1
1 1 1 1 0 0 1 1 1 0 0 0 0 5 1
1 0 0 8 0 0 0 0 0 0 8 0 1 0 1
1 1 10 8 1 8 8 1 0 8 1 0 0 0 1
1 8 5 1 0 8 0 1 0 0 1 1 8 8 1
1 4 1 8 0 7 8 1 0 8 8 8 1 0 1
1 8 0 8 0 8 0 1 0 8 8 8 0 3 1
1 1 1 1 1 1 1 1 1 1 1 1 1 1 1