1 1 1 1 1 1 1 1 1 1 1 1 1 1 1
1 2 8 8 1 8 8 1 8 8 8 8 8 8 1
1 8 1 8 8 8 8  8 8 8 8 1 8 1
1 8 8 1 1 8 8 1 8 8 8 1 8 8 1
1 8 8 1 1 8 8 1 8 8 1 8 8 8 1
1 8 1 8 8 8 1 8 8 8 8 8 8 8 1
1 8 8 8 8 8 1 8 1 8 8 1 1 1 1
1 1 1 1 8 8 1 5 1 8 8 8 8 8 1
1 8 8 8 8 8 1 8 1 8 8 8 1 8 1
1 1 8 8 1 8 8 8 8 8 1 8 8 8 1
1 8 8 1 8 8 8 1 8 8 1 1 8 8 1
1 8 1 8 8 8 8 1 8 8 8 8 1 8 1
1 8 8 8 8 8 8 1 8 8 8 8 8 3 1
1 1 1 1 1 1 1 1 1 1 1 1 1 1 1