1 1 1 1 1 1 1 1 1 1 1 1 1 1 1
1 2 0 0 0 0 0 1 0 0 0 0 0 0 1
1 0 1 0 0 0 0 1 0 0 0 0 1 0 1
1 0 0 1 1 0 0 1 0 0 0 1 0 0 1
1 0 0 1 1 0 0 1 0 0 1 0 0 0 1
1 0 1 0 0 0 8 8 8 0 0 0 0 0 1
1 0 0 0 0 4 1 1 1 0 0 1 1 1 1
1 1 1 1 0 5 1 1 1 0 0 0 0 0 1
1 0 8 8 8 6 0 8 8 8 0 0 1 0 1
1 1 0 0 1 7 0 1 0 0 1 0 0 0 1
1 0 0 1 0 0 0 1 0 0 1 1 0 0 1
1 0 1 8 8 9 0 1 0 0 0 0 1 0 1
1 0 0 8 8 10 0 1 0 0 0 0 0 3 1
1 1 1 1 1 1 1 1 1 1 1 1 1 1 1